o.#..###.###
#.##........
#..##..####.
##.......#.#
.##..#.#...#
.#..#..###..
...#....####
#.##.#..#...
#..#.#.##.#*
###..#....##
