############
#..........#
#.####...#.#
#.#......#.#
#.###.*..#.#
#...##...#.#
#.#.#..#.#.#
#.#.##.#.#.#
#o#......#.#
############
