############
#..........#
#...######.#
#.#....#...#
#.###.*#.#.#
#...##.#.#.#
#.#.#..#.#.#
#.#.#.##.#.#
#o#......#.#
############
