............
...#.o......
...#........
...#........
...#........
...#........
...#........
...#........
...#........
...####.....
..*.........
............
