.o##...###....##
#....#.....##...
###.##.#..####..
#......##@.####.
#..############.
#..##.@..###....
..###.....##..##
..#####...######
.##.@###.###...#
.....###.#.#.#..
#######..#...##.
...#####...###..
#.#.#..##..###..
#...##....###..#
###..####.###.##
####@########*##
